6 6 6 6 6 6 6 6 6 6 6 6 6 6 6 6 6 6 6 6 6 6 6 6 6 6 6 6 6 6 6 6 6 6 6 6 6 6 6 6 6 6 6 6 6 6 6 6 6 6
9 0 0 43 44 44 44 44 44 44 45 0 13 14 13 14 13 14 13 14 13 14 13 14 13 14 13 14 13 14 13 14 0 114 0 0 0 0 0 0 0 0 0 0 0 0 113 0 0 7
9 0 0 40 41 41 41 41 41 41 42 0 15 16 15 16 15 16 15 16 15 16 15 16 15 16 15 16 15 16 15 16 1 1 1 1 1 1 1 1 1 1 1 1 1 1 1 1 0 7
9 0 0 37 38 38 38 38 38 38 39 0 19 20 19 20 17 18 17 18 17 18 17 18 17 18 19 20 19 20 19 20 1 1 1 1 1 1 1 1 1 1 1 1 1 1 1 1 0 7
9 0 2 29 30 31 32 33 34 34 36 0 15 16 15 16 1 1 1 1 1 1 1 1 1 1 15 16 15 16 15 16 1 1 13 14 13 14 13 14 1 1 13 14 13 14 1 1 0 7
9 0 2 21 22 23 24 25 26 26 28 0 19 20 19 20 1 1 1 1 1 1 1 1 1 1 19 20 19 20 19 20 1 1 15 16 15 16 15 16 1 1 15 16 15 16 1 1 0 7
9 0 0 0 0 115 117 116 0 0 0 0 15 16 15 16 1 1 13 14 13 14 13 14 1 1 15 16 15 16 15 16 1 1 19 20 19 20 19 20 1 1 19 20 19 20 1 1 0 7
9 0 0 0 0 1 1 1 0 114 0 0 17 18 17 18 1 1 15 16 15 16 15 16 1 1 17 18 17 18 17 18 1 1 15 16 15 16 15 16 1 1 15 16 15 16 1 1 0 7
9 1 1 1 1 1 1 1 1 1 1 1 1 1 1 1 1 1 19 20 19 20 19 20 1 1 1 1 1 1 1 1 1 1 19 20 17 18 17 18 1 1 17 18 19 20 1 1 0 7
9 1 1 1 1 1 1 1 1 1 1 1 1 1 1 1 1 1 15 16 15 16 15 16 1 1 1 1 1 1 1 1 1 1 15 16 114 1 1 1 1 1 1 1 15 16 1 1 0 7
9 0 0 13 14 13 14 13 14 13 14 13 14 13 14 13 14 0 19 20 19 20 19 20 13 14 13 14 13 14 13 14 13 14 19 20 1 1 2 2 2 2 2 1 19 20 1 1 114 7
9 13 14 15 16 15 16 15 16 15 16 15 16 15 16 15 16 0 15 16 15 16 15 16 15 16 15 16 15 16 15 16 15 16 15 16 1 2 2 2 2 2 2 1 15 16 1 1 0 7
9 15 16 19 20 19 20 19 20 19 20 19 20 19 20 19 20 0 19 20 19 20 19 20 19 20 19 20 19 20 19 20 19 20 19 20 1 2 2 2 2 2 1 1 19 20 1 1 0 7
9 19 20 15 16 15 16 15 16 15 16 15 16 15 16 15 16 0 15 16 15 16 15 16 15 16 15 16 15 16 15 16 15 16 15 16 1 1 1 1 1 1 1 0 15 16 1 1 0 7
9 15 16 17 18 17 18 17 18 17 18 17 18 17 18 17 18 0 19 20 19 20 19 20 17 18 17 18 17 18 17 18 17 18 19 20 13 14 13 14 13 14 13 14 19 20 1 1 0 7
9 19 20 1 1 1 1 1 1 1 1 1 1 1 1 1 1 1 15 16 15 16 15 16 1 1 1 1 1 1 1 1 1 1 15 16 15 16 15 16 15 16 15 16 15 16 1 1 0 7
9 15 16 1 0 13 14 13 14 13 14 13 14 13 14 13 14 1 19 20 19 20 19 20 1 1 1 1 1 1 1 1 1 1 17 18 17 18 17 18 17 18 17 18 17 18 1 1 0 7
9 19 20 1 0 15 16 15 16 15 16 15 16 15 16 15 16 1 15 16 15 16 15 16 1 1 0 71 72 73 74 0 1 1 1 1 1 1 1 1 1 1 1 1 1 1 1 1 0 7
9 15 16 1 0 19 20 17 18 17 18 17 18 19 20 19 20 1 19 20 19 20 19 20 1 1 0 75 76 77 78 0 1 1 1 1 1 1 1 1 1 1 1 1 1 1 1 1 0 7
9 19 20 1 0 15 16 3 3 3 3 3 3 15 16 15 16 1 15 16 15 16 15 16 1 1 0 79 80 81 82 0 1 1 0 0 0 0 0 0 0 1 1 13 14 13 14 13 14 7
9 15 16 1 0 19 20 3 3 3 3 3 3 19 20 19 20 1 19 20 19 20 19 20 1 1 0 83 84 85 86 0 1 1 0 87 88 89 90 91 0 1 1 15 16 15 16 15 16 7
9 19 20 1 0 15 16 3 3 3 3 3 3 15 16 15 16 1 15 16 15 16 15 16 1 1 0 0 0 0 0 108 1 1 0 92 93 94 95 96 0 1 1 19 20 19 20 19 20 7
9 15 16 1 0 19 20 13 14 1 1 13 14 19 20 17 18 1 19 20 19 20 19 20 1 1 1 1 1 1 1 1 1 1 0 97 98 99 100 101 0 1 1 15 16 15 16 15 16 7
9 19 20 1 0 15 16 15 16 1 1 15 16 15 16 1 1 1 15 16 15 16 15 16 1 1 1 1 1 1 1 1 1 1 0 102 103 104 105 106 0 1 1 19 20 19 20 19 20 7
9 15 16 1 112 17 18 17 18 1 1 19 20 19 20 1 13 14 19 20 19 20 19 20 13 14 13 14 13 14 0 1 1 1 0 0 0 0 111 0 0 1 1 15 16 15 16 15 16 7
9 19 20 1 1 1 1 1 1 1 1 15 16 15 16 1 15 16 15 16 15 16 15 16 15 16 15 16 15 16 0 1 1 1 1 1 1 1 1 1 1 1 1 17 18 17 18 17 18 7
9 15 16 13 14 13 14 13 14 13 14 19 20 19 20 1 19 20 19 20 19 20 17 18 17 18 17 18 17 18 0 1 1 1 1 1 1 1 1 1 1 1 1 1 1 1 1 1 1 7
9 19 20 15 16 15 16 15 16 15 16 15 16 15 16 1 15 16 15 16 15 16 0 1 1 1 1 1 1 1 1 1 1 0 0 0 0 0 0 0 1 1 1 1 1 1 1 1 1 7
9 15 16 17 18 17 18 17 18 17 18 17 18 17 18 1 17 18 17 18 17 18 109 1 1 1 1 1 1 1 1 1 1 0 46 47 48 49 50 0 1 1 0 0 0 0 0 0 0 7
9 19 20 1 1 1 1 1 1 1 1 1 1 1 1 1 1 1 1 1 1 1 1 1 1 0 87 88 89 90 91 1 1 0 51 52 53 54 55 0 1 1 0 87 88 89 90 91 0 7
9 15 16 1 1 1 1 1 1 1 1 1 1 1 1 1 1 1 1 1 1 1 1 1 1 0 92 93 94 95 96 1 1 0 56 57 58 59 60 0 1 1 0 92 93 94 95 96 0 7
9 19 20 1 1 13 14 13 14 13 14 13 14 13 14 13 14 13 14 13 14 13 14 1 1 0 97 98 99 100 101 1 1 0 61 62 63 64 65 0 1 1 0 97 98 99 100 101 0 7
9 15 16 1 1 15 16 15 16 15 16 15 16 15 16 15 16 15 16 15 16 15 16 1 1 0 102 103 104 105 106 1 1 0 66 67 68 69 70 0 1 1 0 102 103 104 105 106 0 7
9 19 20 1 1 19 20 19 20 19 20 19 20 17 18 17 18 17 18 17 18 19 20 1 1 0 0 107 0 0 0 1 1 0 0 0 0 0 110 0 1 1 0 0 0 107 0 0 0 7
9 15 16 1 1 15 16 15 16 15 16 15 16 3 3 3 3 3 3 3 3 15 16 1 1 1 1 1 1 1 1 1 1 1 1 1 1 1 1 1 1 1 1 1 1 1 1 1 1 7
9 17 18 1 1 17 18 17 18 17 18 17 18 3 3 3 3 3 3 3 3 19 20 1 1 1 1 1 1 1 1 1 1 1 1 1 1 1 1 1 1 1 1 1 1 1 1 1 1 7
9 1 1 1 1 1 1 1 1 1 1 1 1 3 3 3 3 3 3 3 3 15 16 1 1 0 0 0 0 0 0 0 1 1 0 0 0 0 0 0 0 1 1 13 14 13 14 13 14 7
9 1 1 1 1 1 1 1 1 1 1 1 1 3 3 3 3 3 3 3 3 19 20 1 1 0 87 88 89 90 91 0 1 1 0 87 88 89 90 91 0 1 1 15 16 15 16 15 16 7
9 13 14 13 14 13 14 13 14 13 14 1 1 3 3 3 3 3 3 3 3 15 16 1 1 0 92 93 94 95 96 0 1 1 0 92 93 94 95 96 0 1 1 19 20 19 20 19 20 7
9 15 16 15 16 15 16 15 16 15 16 1 1 13 14 13 14 13 14 13 14 19 20 1 1 0 97 98 99 100 101 0 1 1 0 97 98 99 100 101 0 1 1 15 16 15 16 15 16 7 
9 17 18 17 18 17 18 19 20 19 20 1 1 15 16 15 16 15 16 15 16 15 16 1 1 0 102 103 104 105 106 0 1 1 0 102 103 104 105 106 0 1 1 19 20 19 20 19 20 7
9 2 2 2 2 0 0 15 16 15 16 1 1 17 18 17 18 17 18 17 18 17 18 1 1 0 0 0 0 0 0 0 1 1 0 0 111 0 0 0 0 1 1 15 16 15 16 15 16 7
9 2 2 2 2 2 2 17 18 19 20 1 1 1 1 1 1 1 1 1 1 1 1 1 1 1 1 1 1 1 1 1 1 1 1 1 1 1 1 1 1 1 1 19 20 19 20 19 20 7
9 2 2 2 2 2 2 2 0 15 16 1 1 1 1 1 1 1 1 1 1 1 1 1 1 1 1 1 1 1 1 1 1 1 1 1 1 1 1 1 1 1 1 15 16 15 16 15 16 7
9 2 2 2 2 2 2 2 0 17 18 13 14 1 1 13 14 0 0 0 0 0 0 0 0 13 14 13 14 13 14 13 14 0 0 0 0 0 0 0 1 1 0 17 18 17 18 17 18 7
9 2 2 2 2 2 2 2 0 0 0 15 16 1 1 15 16 0 3 3 3 3 3 3 0 15 16 15 16 15 16 15 16 3 3 3 3 3 3 0 1 1 0 3 3 3 3 3 3 7
9 2 2 2 2 2 2 2 2 2 0 19 20 1 1 19 20 0 3 3 3 3 3 3 0 19 20 19 20 19 20 19 20 3 3 3 3 3 3 1 1 1 1 3 3 3 3 3 3 7
9 2 2 2 2 2 2 2 2 2 2 15 16 1 1 15 16 0 3 3 3 3 3 3 0 15 16 15 16 15 16 15 16 3 3 3 3 3 3 1 1 1 1 3 3 3 3 3 3 7
9 2 2 2 2 2 2 2 2 2 2 17 18 1 1 17 18 0 3 3 3 3 3 3 0 17 18 17 18 17 18 17 18 3 3 3 3 3 3 0 0 0 0 3 3 3 3 3 3 7
9 8 8 8 8 8 8 8 8 8 8 8 8 8 8 8 8 8 8 8 8 8 8 8 8 8 8 8 8 8 8 8 8 8 8 8 8 8 8 8 8 8 8 8 8 8 8 8 8 8